{
    "up"    : ["B", "FW7"],
    "down"  : ["B", "RV7"],
    "right" : ["B", "FLT"],
    "left"  : ["B", "BRK"],
    "space" : ["A", "BRK"],
    "0"  : ["A", "FLT"],
    "1"  : ["A", "FW1"],
    "2"  : ["A", "FW2"],
    "3"  : ["A", "FW3"],
    "4"  : ["A", "FW4"],
    "5"  : ["A", "FW5"],
    "6"  : ["A", "FW6"],
    "7"  : ["A", "FW7"],
    "a"  : ["A", "RV1"],
    "b"  : ["A", "RV2"],
    "c"  : ["A", "RV3"],
    "d"  : ["A", "RV4"],
    "e"  : ["A", "RV5"],
    "f"  : ["A", "RV6"],
    "g"  : ["A", "RV7"]
}